NO ./textures/north.xpm

SO ./textures/south.xpm

WE ./textures/west.xpm

EA ./textures/east.xpm

F 90,90,90

C 173,216,240

11111111111111111111
10000000000000000001
10000000001000000001
1000000000N000000001
11111111111111111111