111111
11 111
101101
1010101
10W001
111011
111111
