NO ./textures/north.xpm

SO ./textures/south.xpm

WE ./textures/west.xpm

EA ./textures/east.xpm

F 123,233,33

C 12,3,4

11111111111
1N1111111
111111111
11111111
11111111111
11111111