NO ./textures/north.xpm

SO ./textures/south.xpm

WE ./textures/west.xpm

EA ./textures/east.xpm

F 90,90,90

C 173,216,240

1111111
1N011
 11     