NO ./textures/north.xpm

SO ./textures/south.xpm

WE ./textures/west.xpm

EA ./textures/east.xpm

F 90,90,90

C 173,216,240

111111
1N0001
100001
111111